22p424e522222242
e4224d2222224u22
22d4quq1112qqq22
p2u211113111u422
24w1311311311p24
2d11133333331122
2113331311333312
213313133113133w
w11131111313112w
p2221113311112d2
242d2242e2211122
2p2e42u22d2p2112