7979797989979977
7lbbbb66666bbbb7
76jy66666666i6j7
7666666666666667
766sm6666666sm67
7666666r6v666667
7o66666z66666o67
7666666666666667
7666666666666667
7666666666666667
7777776666777777
7777776c66777777