1412211412221141
1241111111141211
42241322aaa11411
2213a2222aaa2111
213aaa2222aaa212
1322a222222aaa21
13222222a22aaa21
213222a2222aaa42
42132aaa22aaa221
221213a22aaa2411
24211142aaa21111
4242421111111124